10 10
wwwwwwwwww
wHw__ww0_w
w_w______w
w_w__w_www
w___ww__#w
w_w__w_w_w
wwww_w___w
w0_w_www0w
w_____w__w
wwwwwwwwww